1111111111111111
1000000000000001
1110000001110001
1100000011100001
1000000110000001
1000000011011001
1000000001110001
1000000000000001
1000010100000001
1000100110000001
1000100000000001
1111111111111111